00000000005
02222202205
01032200005
00222222405
00222000005
00000000005
55555555555
55555555555
55555555555
55555555555
55555555555
