00000000005
02222224405
02320002205
01022222205
02223022205
02022000005
00000000005
55555555555
55555555555
55555555555
55555555555
