00000000000
01222022220
02232220220
02002020020
02222422320
00204040200
02322422220
02002020020
02202223220
02222022220
00000000000
