00000000000
01222022220
02332220220
02002020020
02222422220
00204040200
02222422220
02002020020
02202223320
02222022220
00000000000
